Pos,Runner,Club,Category,St Andrews 5M,Strathkinness-Blebocraigs,Hill of Tarvit,Dunnikier,Total,Completed
1,Fiona Callaghan,Dundee Road Runners,FS,192,194,195,195,776,Y
2,Jennifer Massie,Dundee Road Runners,FS,190,192,191,193,766,Y
3,Tom Rainey,Anster Haddies,M40,193,193,181,197,764,Y
4,Hilary Ritchie,Fife AC,F60,185,193,190,190,758,Y
5,Pamela Cruickshanks,Anster Haddies,F50,188,185,188,191,752,Y
6,Thomas Robertson,Fife AC,MU20,187,187,177,191,742,Y
7,Jim Morton,Dundee Road Runners,M50,180,183,182,188,733,Y
8,Sandra Gardener,Falkland Trail Runners,F50,168,175,177,181,701,Y
9,Malcolm Forbes,Dundee Road Runners,M60,173,175,164,186,698,Y
10,Christian Harding,Fife AC,M40,171,167,171,184,693,Y
11,Allan Gibson,Anster Haddies,M70,156,155,153,171,635,Y
12,Rhona Van Rensburg,Fife AC,F50,200,200,0,200,600,N
13,Ben Hukins,PH Racing,M40,197,200,200,0,597,N
14,Ben Kinninmonth,Fife AC,MS,198,0,199,199,596,N
15,Hannah Tippetts,Dundee Road Runners,FS,196,196,197,0,589,N
16,Adam Hart,Dundee Road Runners,MS,196,197,195,0,588,N
17,James Barnet,Dundee Road Runners,MS,195,196,193,0,584,N
18=,Robyn Graham,Falkland Trail Runners,FS,0,189,196,194,579,N
18=,Louise Lessels,Falkland Trail Runners,F40,0,191,192,196,579,N
20=,Fiona Canavan,Dundee Road Runners,FS,195,188,0,192,575,N
20=,Jonathan Millar,Carnegie Harriers,MS,192,0,189,194,575,N
22,Bryan McLaren,Leven Las Vegas RC,MS,0,194,188,192,574,N
23,Iain Wallace,PH Racing,M50,191,191,187,0,569,N
24,Paul Harkins,Fife AC,M40,175,0,178,189,542,N
25,David Place,Fife AC,M50,178,182,179,0,539,N
26,Michael Mitchell,Dundee Road Runners,M50,190,188,160,0,538,N
27,Eric Anderson,Anster Haddies,M40,179,180,173,0,532,N
28,Mike Murdoch,Falkland Trail Runners,M40,0,174,170,181,525,N
29,Will Gage,Anster Haddies,M50,169,178,174,0,521,N
30,Jeff Taylor,Leven Las Vegas RC,M50,0,163,163,176,502,N
31,Lee Cessford,Falkland Trail Runners,M40,162,0,156,177,495,N
32=,John Kinninmonth,RunSum Running Kirkcaldy,M50,164,162,166,0,492,N
32=,Martin Rollo,Dundee Road Runners,M50,167,164,161,0,492,N
34,David Pease,Falkland Trail Runners,M50,0,160,157,173,490,N
35,Bill Gillan,Recreational Runners,M70,0,159,152,175,486,N
36,Nick Brian,Fife AC,M60,158,154,0,172,484,N
37,Heather Anderson,Fife AC,F40,199,0,200,0,399,N
38,Jamie Lessels,Fife AC,MU20,199,0,198,0,397,N
39,Alison McNeilly,Dundee Road Runners,F40,197,197,0,0,394,N
40,Lynne Herd,Anster Haddies,F40,194,0,0,198,392,N
41,Matthew Beaney,Dundee Road Runners,MS,0,192,192,0,384,N
42,Tony Martin,Falkland Trail Runners,M70,188,0,186,0,374,N
43=,Margaret Martin,Fife AC,F60,0,184,189,0,373,N
43=,Merce Torres,Fife AC,F40,187,186,0,0,373,N
45=,Stephen Dickson,Fife AC,M40,186,0,185,0,371,N
45=,Vince MacPherson,Unatt.,M40,0,189,0,182,371,N
47,Dominic Hughes,Dundee Road Runners,MS,0,185,183,0,368,N
48,Michael Reilly,Anster Haddies,M40,183,0,184,0,367,N
49,Bethan McRobbie,Unatt.,FS,0,181,185,0,366,N
50,Kevin Murray,Falkland Trail Runners,M50,0,0,180,185,365,N
51=,Hendrik Van Rensburg,Fife AC,M50,177,184,0,0,361,N
51=,George Young,Falkland Trail Runners,M40,0,181,0,180,361,N
53,Ross McArthur,Falkland Trail Runners,MS,0,179,175,0,354,N
54,John McIntosh,Dundee Road Runners,M50,174,176,0,0,350,N
55=,Rosemary Lee,Falkland Trail Runners,F60,0,169,0,180,349,N
55=,Fiona Walker,Fife AC,F50,171,0,178,0,349,N
57,Philip Suttie,Falkland Trail Runners,M40,170,177,0,0,347,N
58=,Steven Brand,Falkland Trail Runners,MS,0,173,168,0,341,N
58=,Carolann Kinnear,Recreational Runners,F40,165,176,0,0,341,N
60,Margaret Robertson,Dundee Road Runners,F70,166,174,0,0,340,N
61,David Dunleavey,Unatt.,M60,0,171,167,0,338,N
62,Lorraine Hands,Recreational Runners,F40,164,173,0,0,337,N
63,John Wilmot,Falkland Trail Runners,M70,166,165,0,0,331,N
64=,Martin Kirkbride,Falkland Trail Runners,M60,0,156,0,174,330,N
64=,John Mill,Dundee Road Runners,M50,0,168,162,0,330,N
64=,Paul Reed,Dundee Road Runners,M40,165,0,165,0,330,N
67,Grant Whytock,Dundee Road Runners,M50,168,158,0,0,326,N
68,Huw Watkins,STAART,MS,0,166,158,0,324,N
69,Richard Cleary,Dundee Road Runners,M50,163,0,159,0,322,N
70=,John Lee,Falkland Trail Runners,M60,0,150,0,166,316,N
70=,Joseph Smith,Unatt.,MS,0,161,155,0,316,N
72,Stewart Davidson,Fife AC,M70,152,152,0,0,304,N
73,Sean Kenyon,Unatt.,M50,0,153,150,0,303,N
74,Alan McLeod,Fife AC,M70,149,151,0,0,300,N
75=,Ryan Lafferty,Fife AC,MS,0,0,0,200,200,N
75=,David Webster,Dundee Road Runners,MS,200,0,0,0,200,N
77=,Anwen Darlington,Dundee Road Runners,FS,0,0,0,199,199,N
77=,Tom Harris,?,MS,0,199,0,0,199,N
77=,Stephanie Johnson,Kinross Road Runners,FS,0,0,199,0,199,N
77=,Alison McGill,?,F40,0,199,0,0,199,N
81=,Rachel Callaghan,?,FS,0,198,0,0,198,N
81=,Caroline Jones,Kinross Road Runners,F40,0,0,198,0,198,N
81=,Mairi Littleson,Dundee Road Runners,FS,198,0,0,0,198,N
81=,Patrick O'Hare,?,MS,0,198,0,0,198,N
81=,Ross Young,Anster Haddies,MS,0,0,0,198,198,N
86=,James Hall,Fife AC,M40,0,0,197,0,197,N
86=,Amy Tait,Falkland Trail Runners,FS,0,0,0,197,197,N
88=,Dave Clark,Fife AC,M40,0,0,0,196,196,N
88=,Alex Reily,Kinross Road Runners,MS,0,0,196,0,196,N
90=,Glenn Barclay,Fife AC,MS,0,0,0,195,195,N
90=,Fiona Cruickshanks,?,FS,0,195,0,0,195,N
90=,Mark Harris,Fife AC,M50,0,195,0,0,195,N
93=,Jamie Anderson,Anster Haddies,MU20,194,0,0,0,194,N
93=,Sarah Paterson,PH Racing,FS,0,0,194,0,194,N
93=,Cameron Watson,Lomond Hill Runners,M50,0,0,194,0,194,N
96=,Sophia Lapper,Dundee Road Runners,FS,193,0,0,0,193,N
96=,Scott McClung,Fife AC,MS,0,0,0,193,193,N
96=,Jane O'Donnell,Dundee Road Runners,F40,0,0,193,0,193,N
99=,Charlene Junkin,Dundee Road Runners,FS,191,0,0,0,191,N
99=,Sam Woolhead,Unatt.,MS,0,0,191,0,191,N
101=,Andy Harley,Fife AC,M40,0,0,0,190,190,N
101=,Susanne Lumsden,?,F40,0,190,0,0,190,N
101=,Murray Speight,Kinross Road Runners,MS,0,0,190,0,190,N
101=,Dominic Williams,?,MS,0,190,0,0,190,N
105=,Mikey Dow,Leven Las Vegas RC,M50,189,0,0,0,189,N
105=,Lesley Reynolds,Carnegie Harriers,F50,0,0,0,189,189,N
105=,Gwen Tivendale,Anster Haddies,F50,189,0,0,0,189,N
108,Heather Finlayson,Fife AC,F50,0,0,0,188,188,N
109=,Vikki Laing,Unatt.,FS,0,0,0,187,187,N
109=,Abigail Mason,?,FS,0,187,0,0,187,N
109=,Richard Melville,Unatt.,M50,0,0,0,187,187,N
109=,Christine Myerscough,Kinross Road Runners,F60,0,0,187,0,187,N
113=,Gordon Coull,?,MS,0,186,0,0,186,N
113=,Judith Dobson,Kinross Road Runners,F60,0,0,186,0,186,N
113=,Morven McIntyre,Dundee Road Runners,FS,186,0,0,0,186,N
113=,Janet McWhinnie,Unatt.,F50,0,0,0,186,186,N
117=,Geoff Campbell,Dundee Road Runners,M40,185,0,0,0,185,N
117=,Lesley Duffy,Recreational Runners,F50,0,0,0,185,185,N
119=,Tim Ennis,Unatt.,MS,184,0,0,0,184,N
119=,Debz Hay,Anster Haddies,F50,0,0,184,0,184,N
119=,Jennifer Morris,Fife AC,F60,0,0,0,184,184,N
119=,Gail Stirling,Dundee Road Runners,F50,184,0,0,0,184,N
123=,Lorraine Dunbar,Dundee Road Runners,F60,183,0,0,0,183,N
123=,Jackie Galloway,Anster Haddies,F60,0,0,0,183,183,N
123=,Tracy Knox,Anster Haddies,F60,0,183,0,0,183,N
123=,Gillian Lopez,Kinross Road Runners,F50,0,0,183,0,183,N
123=,John MacPherson,Fife AC,M40,0,0,0,183,183,N
128=,David Baird,Dundee Road Runners,MS,182,0,0,0,182,N
128=,Tracy Chalmers,Anster Haddies,F40,0,0,0,182,182,N
128=,Alice Hall,?,F60,0,182,0,0,182,N
128=,Louise Provan,Unatt.,F40,182,0,0,0,182,N
128=,Wendy Turnbull,Kinross Road Runners,F50,0,0,182,0,182,N
133=,Zuleika Brett,Carnegie Harriers,F40,181,0,0,0,181,N
133=,Allan Kettles,Dundee Road Runners,M50,181,0,0,0,181,N
133=,Simone Young,Kinross Road Runners,F50,0,0,181,0,181,N
136=,Catriona Duncan,?,F70,0,180,0,0,180,N
136=,Hannah Lopez,Kinross Road Runners,FS,0,0,180,0,180,N
136=,Katy McBride,Unatt.,F50,180,0,0,0,180,N
139=,Andy Ballentine,Kirkcaldy Wizards,M50,0,0,0,179,179,N
139=,Karen Campbell,Falkland Trail Runners,F60,0,0,179,0,179,N
139=,Gordon Christie,Unatt.,F50,179,0,0,0,179,N
139=,Carol Landale,?,F40,0,179,0,0,179,N
143=,Kim Dickson,?,F50,0,178,0,0,178,N
143=,Amy Tavendale,Dundee Road Runners,F40,178,0,0,0,178,N
143=,Greg Wilson,Kirkcaldy Wizards,M40,0,0,0,178,178,N
146=,Shona Candlish,Dundee Road Runners,FS,177,0,0,0,177,N
146=,Gillian Murdoch,?,F40,0,177,0,0,177,N
148=,Kim Dickson,Fife AC,F50,0,0,176,0,176,N
148=,Eleanor Lowrie,Dundee Road Runners,F50,176,0,0,0,176,N
148=,Chris Neilson,Dundee Road Runners,M40,176,0,0,0,176,N
148=,Craig Roberts,Unatt.,MS,0,0,176,0,176,N
152,Rebecca Garside,Dundee Road Runners,F40,175,0,0,0,175,N
153,Lissa Stewart,Dundee Road Runners,F40,174,0,0,0,174,N
154,May Smith,Dundee Roadrunners,FS,173,0,0,0,173,N
155=,Mark Feely,?,M50,0,172,0,0,172,N
155=,Clive Roberts,Fife AC,M60,0,0,172,0,172,N
155=,Paula Roberts,?,F50,0,172,0,0,172,N
155=,Susan Smith,Dundee Road Runners,F40,172,0,0,0,172,N
155=,Jeremy Tomlinson,Fife AC,M60,172,0,0,0,172,N
160,Julia Greig,?,F40,0,171,0,0,171,N
161=,Lyle Allan,?,M60,0,170,0,0,170,N
161=,Sean Duffy,Unatt.,M40,0,0,0,170,170,N
161=,Katrina Johnston,?,F40,0,170,0,0,170,N
161=,Eugenie Verney,Dundee Road Runners,F60,170,0,0,0,170,N
165=,Kim Dickson,Recreational Runners,F50,169,0,0,0,169,N
165=,Allen Marr,?,M60,0,169,0,0,169,N
165=,Kevin O'Neill,Kirkcaldy Wizards,M50,0,0,0,169,169,N
165=,Stuart Williamson,Fife AC,M50,0,0,169,0,169,N
169,Jim McWhinnie,Unatt.,M60,0,0,0,168,168,N
170=,Jude Alcock,Falkland Trail Runners,F60,167,0,0,0,167,N
170=,Allan Galloway,Anster Haddies,M40,0,0,0,167,167,N
172,Barbara Mary Brown,Dundee Road Runners,F60,163,0,0,0,163,N
173,Carrie Baird,Dundee Road Runners,FS,162,0,0,0,162,N
174=,Linda Craddock,Dundee Road Runners,F50,161,0,0,0,161,N
174=,Frank McLaren,Fife AC,M70,161,0,0,0,161,N
176,Daniel Haran,GTC,M50,160,0,0,0,160,N
177,Phillip Gillespie,Dundee Road Runners,M50,159,0,0,0,159,N
178=,Ewan Cameron,Anster Haddies,M60,157,0,0,0,157,N
178=,Ian Donaldson,?,M50,0,157,0,0,157,N
180,Robert Garside,Dundee Road Runners,M40,155,0,0,0,155,N
181=,Josh McKay,Dundee Road Runners,MS,154,0,0,0,154,N
181=,John Myerscough,Kinross Road Runners,M60,0,0,154,0,154,N
183,Ed Wade,Fife AC,M70,153,0,0,0,153,N
184=,John Keenlyside,Fife AC,M70,151,0,0,0,151,N
184=,Russ Valentine,Falkland Trail Runners,M60,0,0,151,0,151,N
186,Michael Creechan,Falkland Trail Runners,M60,150,0,0,0,150,N
187,Mike Alcock,Falkland Trail Runners,M70,148,0,0,0,148,N
